{
	"enemySpawnPoints":[],
	"mapTiles":[
		"WWWWWWWWWWWWWWWWWWWWWWWWWWWWWWWWWWWWWWWWWWWWWWWWWWWWWWWWWWWWWWWWWWWWWWWWWWWWWWWWWWWWWWWWWWWWWWWWWWWWWWWWWWWWWWWWWWWWWWWWWWWWWWWWWWWWWWWWWW",
		"W5555554555555444445444444455555554444444444444444444445455545544444444444444444445455545555555555555555555555555555555555565565555555555W",
		"W5555555555555444444444444455555554444444444444444444545444444444444444444544444454444545555555555555555555555555555555555555656555555555W",
		"W5555555555554544445444444455555444444444444444444444455445444444444444444444444445544555555555556555555555555555555555555555555655555555W",
		"W55555555B5555545444444444445555444444444444444444444445544444444444444444454444445544455556555655665555555555555555555555555555555555555W",
		"W55555555555555554444444444455554444444444444R4444444545554444444444444554455444445554455556555665565555555555555555555555555555556555555W",
		"W5555555555555544444444444444555544444444444444444444445554544444444444554545544445545555555555555565555555555555555555555555555566555555W",
		"W5555555555555555554455444445455544444444444444444444455554445444444444554454554444454455555555565555555555555555555555555555555556555555W",
		"W5555555555555555454445444455554454444444444544444444555555444544444444444454444444555545555555555555555555555555555555555555555555555555W",
		"W5555555555555555544445444555444445544444444444444444555555455444444444444444555444555555555555555555555555555555555555555555555555555555W",
		"W5555555554555555544445444554444444544444454544444444555554455554444444444444445545555555555555555555555555555555555555555555555555555555W",
		"W5555555555555555554555555555554444444444444554444444555555444544444444544444445454555555555555555655555555555555555555555555555555555555W",
		"W5555555554555555555555455555545444444444445444444444455555445555544444444444444454445555555555555556555555555555555555555555555555555555W",
		"W5555554455455555555544455555444444444444455544444444451554545555544444454444444444555555555555555555565555555555555555555555555555555555W",
		"W5555554555454555545555545555544444444444445544444444415555555555544444444444444444555555555555555555555555555554555555555555555555555555W",
		"W5555555555545555555555455555544444444444445544444444415555545555454444444444444445555555555554555555555555555555555555555555555555555555W",
		"W5555555555555545555555555555444444444444545544444444455555545555544444444444444444455555555555445455555555555555555555555556555555555555W",
		"W5555555555555555555555555554444444444444455545444444145555555554444444444444444455555555555554445555555555555555555555555556555555555555W",
		"W5555555555555555455555555544444444444444455555444444445555555554444544444444444444555555555554445555555555555555555555555555555555555555W",
		"W5555555555555544555555555555454444444444455545444444445555555544444544444444444444555555555554545555555555555555555555555555565555555555W",
		"W5555555555555554545455555554455444444444455555544444444455555544544555444444444444454455555554455554555554555555555455555555565555555555W",
		"W5555555555555445545555555555455444444444455555444414444455555545444444444444444444445455455554455555555554555555555555555555565655555555W",
		"W5555555555555554555555555555554544444444445555444444444555555554444444444444444445454455544545555455555445555555555555555555555655555555W",
		"W5555555555555555545555555555554554544444445555444444444444555544444444444444444444544445544544555555455455555555556555555555555555555555W",
		"W5555555555555555444555555555555555554444444555541444444444555555444444444444444445444454554445554544454555565555555555555555555555555555W",
		"W5555555555555555545455545555555555554444445555444444444444455555444444444444444444444445544444455544444555555555555555555555565565555555W",
		"W5555555555555554454555545555555555554444444555444444444444455555444444444444444444444444444444455544454555555555555555555555556555555555W",
		"W5555555555555555555455545555555555555544444554414444444444455555444444444444444444444554444445445455555555555565555555555555556555555555W",
		"W5555555555555555555444545554555555555544444554144444444444455554544444444444444444444544444455444455554545555565555555555555555555555555W",
		"W5555555555555555554445445554545555555444444554444444444444455554544454444444444444444444444445544555554555566565555555555555555655555555W",
		"W5555555554555455555444445454545555555544444554444444444454455555444545544444444444445544444555554555554555556556555555555555555555555555W",
		"W5555555555555444555444445455445555555444444555444444445454555555555555444444544444444444444455554455555555555556555555555555555555556555W",
		"W5555555555555545454455444444445555455444444454444444444554555555555555444444444444444444444445555555555455555556655555555555555555555555W",
		"W5555555555554554454454444454455555444444444454444444444555556555555554444444444444444444444455555555555555555556655555555555555555555655W",
		"W5555555555555555545545444444544555444444444444444444454455555555545544444444544444444444444455555555555555555556665555555555555555555565W",
		"W5555555555555555455555544444444445544444444444444444454555555554545544444444444444444444444445555555555555555555666555555555555555555555W",
		"W5555555555555545555455554444444444444444444444444444454556555655544554444444444444444444444445555556555555555555566555555555555555555655W",
		"W5555555555545555554455544444445445544444444444444444455565555555544454444444444444444444445545555555555555555555656555555555555555555665W",
		"W5555555555555555555555544444444444444444444444444444455555555555554444444444444444444444455545555555555555555555666555555555555555565655W",
		"W5555555555555555555555554454444444444444444444444444555555555555554454444444444444444444445555555555555555555555666555555555555555555665W",
		"W5555555555555555555555555544544444444444444444444444555555555555554445454444444444444444445555555555555555655556666555555555555555555665W",
		"W5555556555555555555555555545444444444444444444444444555555555455554445454444444444444444455555555555555555555556665655555555555555555555W",
		"W5555555555555555555555555544444444444444444444444445556554544455554444444444444444444444444545555555555556555556655655555555555555555555W",
		"W5555555555555555555555555545454444444444444444444445565555444555554444444454444444444444445445555555555555655556665555555555555555555555W",
		"W5555555565555555555555555555544455444444444444444444555554454454554444444454444444444444444444555455555555555555655555555555555555555555W",
		"W5555555555555555555555554545544444444455554444444444565555554454455444444444444444454444444445554445555555555556555555555555555555555555W",
		"W5555555555555555555555555555544554444555544444444444555555554444454444444454444444454444444445444455555555565555555665555555555555555555W",
		"W5555555555555555555555555555545554444555544444444444555555554444444444444555444444454444444444454555555555565555555666555555555555555555W",
		"W5555555555555555555555555555544544444455555444444444555555555454444444444445444445554444444444444455555555556565665666655555555555555555W",
		"W5555555555555555555555555555555544444444554444444444556555555544444444444444444455554444444444444555554555566665565666655555555555555555W",
		"W5555555555555555555555555555555554444445554444444555455655555554544444454444444455654444444444444555554555555556666666655555555555555555W",
		"W5555555555555555555555555555555554444445555444444444455555555545544444554444444445554444444444444445554555555555566666655555555555555555W",
		"W5555555555555555555555555555555444444444555444444444445565555445544444444444444455554444444444444445545555555555566666655555555555555555W",
		"W5555555555555555555555555555555554544444555444444444444566555545555445444444444455554444454444444455544555555555556666665555555555555555W",
		"W5555555555555555555555555555555555544444555444444444444555555545544445444444444445554444444444444455544555555555566666665655555555555555W",
		"W5555555555555555555555555555555555554444455544444444445555555455554445544444454455554444554444444445545555555555555666666665555555555555W",
		"W5555555555555555555555555555555555555444555554444444444455555555544444444444445455555454544444444444545555545555555566666655555555555555W",
		"W5555555555555555555555555555555555554444444555444444555555555555555455444444455555554555544444444444445455555555555556666656655555555555W",
		"W5455455555555555555555555555555445544444444555444444555555554455555555444445555555555455444444444444444555545445555556566555655555665555W",
		"W555555555555R555555555555555555554444444444455554445555555555555555455444444545555555555444444444444444455545445555556566655655555555555W",
		"W5555555555555555555555555555555555454545444455554445555555555555555554444444455555555555544445544444444455444455555555655655665555555555W",
		"W5555555555555555555555555555555554444454444445555444555555554555555555444444444555555555544455444444444454444545555555555555666555555555W",
		"W5555555555555555555555555555555544444554454455554444555555555555555554444444444555555554544455544444444444444455455555556555666555555555W",
		"W5555555555555555555555555555555444545555555445554544555555555555555554444444445555555555444555544444444444444454455555556555566555555555W",
		"W5555555555555555555555555555554444545555554444555544555555555555555555444444445455555555544555554444454444444445455555555555666655565555W",
		"W5555555555555555555555555555555445455555554444555544555555555556555555444444554455555555544555544444454444445444555555555556666655665555W",
		"W5555555555555555555555455555544555555555555444555555555555555556555555454444455555555555444555554444444544554444555555455556666655555555W",
		"W5555555555555555555555555555554555555555555444555555445555555555655555554444455555555555444555544544445554554444455555455566666665555555W",
		"W5555555555555555555555555445554555555555555554445555455555555555555555554445555555555555444455545544445555554544455555455556565555555555W",
		"W5555555555555555555555555554445545555555555544455555554555555555555555544444555555555545555555554544445555554444455555455566566555555555W",
		"W5555555555555555555555555555555555555555545554455555555555555555555554444445555555555555445455555544544555555554445554555666556555555555W",
		"W5555555555555555555555555555555555555555554444455555555555555555555545554444455555555555555555555555445555555554445554555566556555555555W",
		"W5555555555555555555555555554555555555555544444445555555555555555555555444444455555555555555555555555445555555554545554555556655555555555W",
		"W5555555555555555555555555554555555555555545555544544555555555555555555444454555555555555555555555555445555555555544444555556565555555555W",
		"W5555555555555555555555555554555555555555545555544445555555555555555554444445545555555555555555555554444555555555544445555555555555555555W",
		"W5555555555555555555555555555555555555555545555444455555555555555555555444445455555555555555555554555445455555555544555555555655555555555W",
		"W5555555555555555555555555555555555555555444555444455555555555555555555444455555555555555555555554555444555555555544455555555655555555555W",
		"W5555555555555555555555555545555555555555555555444555555555555565555444444455555555655555555555555555455555555555554455555555665555555555W",
		"W5555555555555555555555555545555555555554455555544455555555555555555544555445555555555555555555555454555555555555554455555555655555555566W",
		"W5555555555555555555555555545555555555555455554554455555555555555555555554444555555555555555555555545455555555555554445554555555555665556W",
		"W5555555555555555555555554555555555555555555555544555555555555555555555554445455555555555555555555455455555555554444445555555555556655556W",
		"WWWWWWWWWWWWWWWWWWWWWWWWWWWWWWWWWWWWWWWWWWWWWWWWWWWWWWWWWWWWWWWWWWWWWWWWWWWWWWWWWWWWWWWWWWWWWWWWWWWWWWWWWWWWWWWWWWWWWWWWWWWWWWWWWWWWWWWWWW"
	],
	"timeLimit":180,
	"versionCode":1
}