WWWWWWWWWWWWWWW
W1111444444556W
W41B1411111456W
W4411144101144W
W5411411000111W
W4411111100112W
W1111111111122W
W4111114444122W
W4114445565442W
W4411144544412W
W4111144441R20W
W1111441112200W
W2211111220000W
WWWWWWWWWWWWWWW