{
	"mapTiles": [
		"WWWWWWWWWWWWWWWWWWWWWWWWWWWWWWWWWWWWW",
		"W11111111111111111111111111111111111W",
		"W11111111111111111111111111111111111W",
		"W11111111111111111111111111111111111W",
		"W11111222222222222222222222222111111W",
		"W11111222222222222222222222222111111W",
		"W11111222222222222222222222222111111W",
		"W11111222222222222222222222222111111W",
		"W11111111111111111111111111111111111W",
		"W11111111111111111111111111111111111W",
		"W11111111111111111111111111111111111W",
		"W11111111111111111111111111111111111W",
		"W11111111111111111113333333333111111W",
		"W11111111111111111133333333333311111W",
		"W11111111111111111333333333333331111W",
		"W11111111111111111133333333333311111W",
		"W11111111111111111113333333333111111W",
		"W11111111111111111111111111111111111W",
		"W11111111111111111111111111111111111W",
		"W11111111111111111111111111111111111W",
		"W11111111111111111111111111111111111W",
		"W11111110000000011100000000000000011W",
		"W11111110000000011100000000000000011W",
		"W11111110000000011100000000000000011W",
		"W11111110000000011100000000000000011W",
		"W11111110000000011100000000000000011W",
		"W11111111111111111111111111111111111W",
		"W11111111111111111111111111111111111W",
		"W11111111111111111111111111111111111W",
		"W11111111111111111111111111111111111W",
		"W11111111111111111111111111111111111W",
		"W11111111111111111111111111111111111W",
		"W11111111111111111111111111111111111W",
		"W11111111111111111111111111111111111W",
		"W11111111111111111111111111111111111W",
		"W11111111111111111111111111111111111W",
		"WWWWWWWWWWWWWWWWWWWWWWWWWWWWWWWWWWWWW"
	],
		"enemySpawnPoints": [
		
	]
}