{
	"timeLimit": 60,
	"mapTiles": [
		"WWWWWWWWWWWWWWWW",
		"W44134411444444W",
		"W1B103444141566W",
		"W11103441115666W",
		"W1133444115511RW",
		"WWWWWWWWWWWWWWWW"
	],
	"enemySpawnPoints": [

	]
}