{
	"mapTiles": [
		"WWWWWWWWWWWWWWWWWWWWWWWWWWWWWWWWWWWWW",
		"W11111111111111111111111111111111111W",
		"W11111111111111111111111111111111111W",
		"W11111111111111111111111111111111111W",
		"W11111111111111111111111111111111111W",
		"W11111111111111111111111111111111111W",
		"W11111111111111111111111111111111111W",
		"W11111111111111111111111111111111111W",
		"W11111111111111111111111111111111111W",
		"W11111111111111111111111111111111111W",
		"W11111111111111111111111111111111111W",
		"W11111111111111111111111111111111111W",
		"W11111111111111111111111111111111111W",
		"W11111111111111111111111111111111111W",
		"W11111111111111111111111111111111111W",
		"W11111111111111111111111111111111111W",
		"W11111111111111111111111111111111111W",
		"W11111111111111111111111111111111111W",
		"W11111111111111111111111111111111111W",
		"W11111111111111111111111111111111111W",
		"W11111111111111111111111111111111111W",
		"W11111111111111111111111111111111111W",
		"W11111111111111111111111111111111111W",
		"W11111111111111111111111111111111111W",
		"W11111111111111111111111111111111111W",
		"W11111111111111111111111111111111111W",
		"W11111111111111111111111111111111111W",
		"WWWWWWWWWWWWWWWWWWWWWWWWWWWWWWWWWWWWW"
	],
		"enemySpawnPoints": [
		
	]
}